                                                                                                        
                                                                                                        
                                                                                                        
                                                *****************                                       
*********************************              *                *  ***********************              
                                 *            *                 *  *                      **********    
                                  ************                  *  *                               *    
                                                                *  *                               *    
                                               ******           ****            **********         *    
*********************************             *     *                          *          *        *    
                                 *           *      *                          *          *        *    
                                  ***********       *                          *          *        *    
                                                    ****************************          *        *    
                                                                                         *        *     
                                                                                        *        *      
*********************************              ******************  *********************        *       
                                 *            *                 *  *                            *       
                                  ************                  *  *                            *       
                                                                *  *                            *       
                                               ******           ****            *****************       
*********************************             *     *                          *                        
                                 *           *      *                          *                        
                                  ***********       *                          *                        
                                                    ****************************                        
                                                                                                         